SOCIAL	NotEntity
HISTORY:	NotEntity
The	NotEntity
patient	NotEntity
is	Status-B
single,	NotEntity
self-employed	Occupation-B
carpenter	Occupation-I
.	NotEntity
He	NotEntity
chews	Status-B
tobacco	NotEntity
or	NotEntity
having	NotEntity
chewing	NotEntity
tobacco	NotEntity
for	NotEntity
30	NotEntity
years,	NotEntity
about	NotEntity
half	Amount-B
a	Amount-I
can	Amount-I
per	NotEntity
day,	NotEntity
but	NotEntity
notes	NotEntity
he	NotEntity
has	NotEntity
been	NotEntity
recently	NotEntity
off,	NotEntity
and	NotEntity
he	NotEntity
does	NotEntity
note	NotEntity
occasional	Frequency-B
moderate	NotEntity
alcohol	Alcohol-B
use	NotEntity
