SOCIAL	NotEntity
HISTORY:	NotEntity
She	NotEntity
was	NotEntity
born	Status-B
in	Status-I
Houston,	NotEntity
Texas	NotEntity
and	NotEntity
moved	NotEntity
to	NotEntity
Florida	NotEntity
about	NotEntity
3	Status-B
years	Status-I
ago.	Status-I
She	NotEntity
is	NotEntity
divorced.	Status-B
She	NotEntity
has	Status-B
worked	Status-I
as	NotEntity
a	NotEntity
travel	NotEntity
agent.	NotEntity
She	NotEntity
has	NotEntity
2	NotEntity
sons	NotEntity
ages	NotEntity
24	Amount-B
and	NotEntity
26,	Amount-B
both	NotEntity
of	NotEntity
whom	NotEntity
are	NotEntity
alive	NotEntity
and	NotEntity
well.	NotEntity
She	NotEntity
smokes	Status-B
a	NotEntity
half	Amount-B
a	Amount-I
pack	Amount-I
of	NotEntity
cigarettes	NotEntity
per	Frequency-B
day	Frequency-I
for	NotEntity
more	NotEntity
than	NotEntity
35	NotEntity
years.	NotEntity
She	NotEntity
does	Status-B
not	Status-I
consume	NotEntity
alcohol	NotEntity
