SOCIAL	NotEntity
HISTORY:	NotEntity
She	NotEntity
is	Status-B
married.	NotEntity
She	NotEntity
works	Status-B
at	NotEntity
Eye	NotEntity
Center	NotEntity
as	NotEntity
a	NotEntity
receptionist.	NotEntity
She	NotEntity
denies	Status-B
tobacco	NotEntity
at	NotEntity
this	NotEntity
time	NotEntity
though	NotEntity
she	NotEntity
was	NotEntity
a	NotEntity
previous	NotEntity
smoker,	NotEntity
stopped	NotEntity
four	NotEntity
years	NotEntity
ago,	NotEntity
and	NotEntity
she	NotEntity
denies	Status-B
alcohol	NotEntity
use	NotEntity
