SOCIAL	NotEntity
HISTORY:	NotEntity
She	NotEntity
works	Status-B
running	NotEntity
a	NotEntity
day	NotEntity
care	NotEntity
at	NotEntity
home.	NotEntity
She	NotEntity
has	NotEntity
three	Amount-B
children.	NotEntity
She	NotEntity
is	Status-B
married.	NotEntity
She	NotEntity
does	Status-B
not	Status-I
smoke,	NotEntity
use	NotEntity
alcohol	Alcohol-B
or	NotEntity
illicit	NotEntity
drugs	Drug-B
