SOCIAL	NotEntity
HISTORY:	NotEntity
She	NotEntity
is	Status-B
a	NotEntity
widow	MaritalStatus-B
.	NotEntity
She	NotEntity
has	NotEntity
8	Amount-B
children	NotEntity
that	NotEntity
are	NotEntity
healthy	NotEntity
with	NotEntity
the	NotEntity
exception	NotEntity
of	NotEntity
one	Amount-B
who	NotEntity
has	NotEntity
coronary	NotEntity
artery	NotEntity
disease	NotEntity
and	NotEntity
has	NotEntity
had	NotEntity
bypass.	NotEntity
She	NotEntity
also	NotEntity
has	NotEntity
a	Amount-B
son	NotEntity
with	NotEntity
lumbar	NotEntity
spine	NotEntity
disease.	NotEntity
No	Status-B
tobacco,	NotEntity
alcohol	Alcohol-B
or	NotEntity
IV	NotEntity
drug	Drug-B
abuse	NotEntity
