SOCIAL	NotEntity
HISTORY:	NotEntity
Significant	NotEntity
history	Status-B
of	Status-I
alcohol	NotEntity
abuse	Amount-B
,	NotEntity
according	NotEntity
to	NotEntity
the	NotEntity
emergency	NotEntity
room	NotEntity
physician,	NotEntity
who	NotEntity
sees	NotEntity
her	NotEntity
on	NotEntity
a	NotEntity
regular	NotEntity
basis	NotEntity
