SOCIAL	NotEntity
HISTORY:	NotEntity
He	NotEntity
is	NotEntity
a	NotEntity
tobacco	Tobacco-B
user.	NotEntity
He	NotEntity
does	Status-B
not	Status-I
drink.	NotEntity
He	NotEntity
lives	Status-B
alone,	NotEntity
but	NotEntity
has	NotEntity
family	NotEntity
and	NotEntity
social	NotEntity
support	NotEntity
to	NotEntity
look	NotEntity
on	NotEntity
him	NotEntity
