SOCIAL	NotEntity
HISTORY:	NotEntity
He	NotEntity
lives	Status-B
alone.	NotEntity
He	NotEntity
recently	NotEntity
lost	NotEntity
his	NotEntity
partner.	NotEntity
This	NotEntity
happened	NotEntity
about	NotEntity
six	NotEntity
months	NotEntity
ago.	NotEntity
He	NotEntity
denies	Status-B
alcohol,	NotEntity
tobacco,	Tobacco-B
or	NotEntity
illicit	NotEntity
drug	Drug-B
use.	NotEntity
He	NotEntity
is	NotEntity
now	Status-B
retired.	NotEntity
He	NotEntity
is	Status-B
very	NotEntity
active	NotEntity
and	NotEntity
walks	NotEntity
about	Amount-B
four	Amount-I
miles	Amount-I
every	NotEntity
few	NotEntity
days	NotEntity
