SOCIAL	NotEntity
HISTORY:	NotEntity
She	NotEntity
does	Status-B
not	Status-I
smoke	NotEntity
cigarettes,	NotEntity
abuse	Amount-B
alcohol,	NotEntity
no	Status-B
use	Status-I
of	NotEntity
illicit	NotEntity
drugs	Drug-B
.	NotEntity
She	NotEntity
is	Status-B
divorced	Status-I
and	NotEntity
lives	Status-B
alone	NotEntity
and	NotEntity
is	NotEntity
a	NotEntity
retired	Status-B
laboratory	NotEntity
technician	NotEntity
from	NotEntity
Cornell	NotEntity
Diagnostic	NotEntity
Laboratory	NotEntity
