SOCIAL	NotEntity
HISTORY:	NotEntity
The	NotEntity
patient	NotEntity
still	Status-B
smokes	NotEntity
about	Amount-B
a	Amount-I
third	Amount-I
of	Amount-I
a	Amount-I
pack	Amount-I
a	NotEntity
day,	NotEntity
also	NotEntity
drinks	Status-B
only	NotEntity
occasional	NotEntity
alcoholic	NotEntity
drinks.	NotEntity
The	NotEntity
patient	NotEntity
is	Status-B
married.	NotEntity
She	NotEntity
has	NotEntity
three	Amount-B
grown	NotEntity
sons,	NotEntity
all	NotEntity
of	NotEntity
which	NotEntity
are	NotEntity
very	NotEntity
successful	NotEntity
in	NotEntity
professional	NotEntity
positions.	NotEntity
One	NotEntity
son	NotEntity
is	NotEntity
a	NotEntity
gastroenterologist	NotEntity
in	NotEntity
San	NotEntity
Diego,	NotEntity
California	NotEntity
