SOCIAL	NotEntity
HISTORY:	NotEntity
Lives	Status-B
with	NotEntity
parents	NotEntity
and	NotEntity
with	NotEntity
two	Amount-B
siblings,	NotEntity
one	NotEntity
18-year-old	Amount-B
and	NotEntity
the	NotEntity
other	NotEntity
is	NotEntity
14-year-old	Amount-B
in	NotEntity
house,	Status-B
in	NotEntity
Corrales.	NotEntity
They	NotEntity
have	NotEntity
animals,	NotEntity
but	NotEntity
outside	NotEntity
the	NotEntity
house	NotEntity
and	NotEntity
father	NotEntity
smokes	NotEntity
outside	NotEntity
house.	NotEntity
No	NotEntity
sick	NotEntity
contacts	NotEntity
as	NotEntity
the	NotEntity
mother	NotEntity
said	NotEntity
