Social	NotEntity
History:	NotEntity
He	NotEntity
is	Status-B
employed	NotEntity
as	NotEntity
a	NotEntity
United	NotEntity
States	NotEntity
Marine	NotEntity
officer,	NotEntity
artillery	NotEntity
repair	NotEntity
specialist.	NotEntity
He	NotEntity
was	Status-B
a	NotEntity
social	Amount-B
drinker	NotEntity
in	NotEntity
the	NotEntity
past	NotEntity
but	NotEntity
quit	NotEntity
altogether	NotEntity
two	NotEntity
years	NotEntity
ago.	NotEntity
He	NotEntity
never	Status-B
used	Status-I
tobacco	NotEntity
products	NotEntity
or	NotEntity
illicit/intravenous	NotEntity
drugs	Drug-B
