Social	NotEntity
History:	NotEntity
The	NotEntity
patient	NotEntity
was	Status-B
from	Status-I
Brazil.	NotEntity
He	NotEntity
moved	Status-B
to	NotEntity
the	NotEntity
United	NotEntity
States	NotEntity
one	NotEntity
year	NotEntity
ago.	NotEntity
He	NotEntity
denied	Status-B
any	Status-I
history	NotEntity
of	NotEntity
tobacco	Tobacco-B
,	NotEntity
alcohol	Alcohol-B
,	NotEntity
or	NotEntity
illicit	NotEntity
drug	Drug-B
use.	NotEntity
He	NotEntity
was	Status-B
married	NotEntity
and	NotEntity
monogamous.	NotEntity
He	NotEntity
worked	Status-B
as	NotEntity
an	NotEntity
engineer/manager	Occupation-B
,	NotEntity
and	NotEntity
stated	NotEntity
that	NotEntity
his	NotEntity
job	NotEntity
was	NotEntity
"very	NotEntity
stressful".	NotEntity
He	NotEntity
had	NotEntity
recently	NotEntity
been	NotEntity
admitted	NotEntity
to	NotEntity
an	NotEntity
MBA	NotEntity
program.	NotEntity
The	NotEntity
patient	NotEntity
denied	Status-B
recent	NotEntity
travel	NotEntity
or	NotEntity
exposures	NotEntity
of	NotEntity
any	NotEntity
kind	NotEntity
