Social	NotEntity
History:	NotEntity
Patient	NotEntity
is	Status-B
married	Status-I
and	NotEntity
lives	Status-B
with	NotEntity
her	NotEntity
husband	NotEntity
and	NotEntity
2	Amount-B
children.	NotEntity
Works	Status-B
in	NotEntity
a	NotEntity
business	NotEntity
office.	NotEntity
Denies	Status-B
any	Status-I
tobacco,	NotEntity
alcohol	Alcohol-B
,	NotEntity
or	NotEntity
illicit	NotEntity
drug	Drug-B
use	NotEntity
of	NotEntity
any	NotEntity
kind.	NotEntity
No	Status-B
history	Status-I
of	NotEntity
sexually	NotEntity
transmitted	NotEntity
diseases.	NotEntity
Denies	Status-B
exposures	Status-I
to	NotEntity
asbestos,	NotEntity
chemicals,	NotEntity
or	NotEntity
industrial	NotEntity
gases.	NotEntity
No	Status-B
recent	Status-I
travel.	NotEntity
No	NotEntity
recent	NotEntity
sick	NotEntity
contacts	NotEntity
