SOCIAL	NotEntity
HISTORY:	NotEntity
Remarkable	NotEntity
for	NotEntity
being	Status-B
married,	NotEntity
retired,	Occupation-B
quit	NotEntity
smoking	NotEntity
in	NotEntity
1997,	NotEntity
rare	Frequency-B
use	Frequency-I
of	NotEntity
alcohol,	Alcohol-B
lives	NotEntity
locally	NotEntity
with	NotEntity
his	NotEntity
wife	NotEntity
