SOCIAL	NotEntity
HISTORY:	NotEntity
She	NotEntity
lives	Status-B
with	NotEntity
her	NotEntity
boyfriend.	NotEntity
The	NotEntity
patient	NotEntity
has	NotEntity
a	NotEntity
history	Status-B
of	NotEntity
heavy	Frequency-B
tobacco	NotEntity
and	NotEntity
alcohol	Alcohol-B
abuse	NotEntity
for	NotEntity
many	NotEntity
years	NotEntity
