SOCIAL	NotEntity
HISTORY:	NotEntity
She	NotEntity
is	NotEntity
a	NotEntity
non	Status-B
smoker	NotEntity
and	NotEntity
non	Status-B
drinker.	NotEntity
She	NotEntity
has	NotEntity
been	NotEntity
widowed	Status-B
for	NotEntity
18	NotEntity
years.	NotEntity
She	NotEntity
lives	Status-B
alone	NotEntity
at	NotEntity
home	Status-B
.	NotEntity
She	NotEntity
is	NotEntity
retired	Status-B
from	NotEntity
running	NotEntity
a	NotEntity
restaurant	NotEntity
