SOCIAL	NotEntity
HISTORY:	NotEntity
The	NotEntity
patient	NotEntity
lives	Status-B
by	NotEntity
herself	NotEntity
and	NotEntity
has	NotEntity
three	NotEntity
pet	NotEntity
cats.	NotEntity
She	NotEntity
is	NotEntity
an	NotEntity
ex-	Status-B
smoker,	NotEntity
quit	NotEntity
smoking	NotEntity
about	NotEntity
five	NotEntity
years	NotEntity
ago.	NotEntity
She	NotEntity
occasionally	Frequency-B
drinks	NotEntity
a	Amount-B
glass	Amount-I
of	NotEntity
wine.	NotEntity
She	NotEntity
denies	Status-B
any	NotEntity
other	NotEntity
recreational	NotEntity
drugs	Drug-B
use.	NotEntity
She	NotEntity
recently	Status-B
retired	Status-I
from	NotEntity
State	NotEntity
of	NotEntity
Pennsylvania	NotEntity
as	NotEntity
a	NotEntity
psychiatric	Occupation-B
aide	Occupation-I
after	NotEntity
32	NotEntity
years	NotEntity
of	NotEntity
service	NotEntity
