SOCIAL	NotEntity
HISTORY:	NotEntity
He	NotEntity
occasionally	Status-B
drinks	NotEntity
and	NotEntity
is	NotEntity
a	NotEntity
nons	Status-B
moker.	NotEntity
The	NotEntity
patient	NotEntity
participated	NotEntity
in	NotEntity
homosexual	NotEntity
activity	NotEntity
in	NotEntity
Haiti	NotEntity
during	Status-B
1982	Status-I
which	NotEntity
he	NotEntity
described	NotEntity
as	NotEntity
"	NotEntity
very	Amount-B
active.	Amount-I
"	NotEntity
Denies	Status-B
intravenous	NotEntity
drug	Drug-B
use.	NotEntity
The	NotEntity
patient	NotEntity
is	NotEntity
currently	Status-B
employed	NotEntity
