OCCUPATIONAL	NotEntity
/SOCIAL	NotEntity
HISTORY:	NotEntity
Marital	NotEntity
status:	NotEntity
married	Status-B
.	NotEntity
Patient	NotEntity
states	NotEntity
smoking	Tobacco-B
history	NotEntity
of	NotEntity
1	Amount-B
pack	Amount-I
per	NotEntity
day.	NotEntity
Patient	NotEntity
quit	NotEntity
smoking	Tobacco-B
1	NotEntity
year	NotEntity
ago.	NotEntity
Admits	NotEntity
to	NotEntity
no	Status-B
history	Status-I
of	NotEntity
using	NotEntity
alcohol	Alcohol-B
.	NotEntity
States	NotEntity
use	NotEntity
of	NotEntity
no	Status-B
illicit	NotEntity
drugs.	Drug-B
