SOCIAL	NotEntity
HISTORY:	NotEntity
He	NotEntity
lives	Status-B
alone.	NotEntity
He	NotEntity
works	Status-B
full	NotEntity
time	NotEntity
in	NotEntity
Human	NotEntity
Resources	NotEntity
for	NotEntity
the	NotEntity
State	NotEntity
of	NotEntity
Maryland.	NotEntity
He	NotEntity
previously	NotEntity
was	Status-B
an	NotEntity
alcoholic	Alcohol-B
,	NotEntity
but	NotEntity
quit	NotEntity
in	NotEntity
1984.	NotEntity
He	NotEntity
also	NotEntity
quit	Status-B
smoking	NotEntity
cigarettes	NotEntity
in	NotEntity
1984,	NotEntity
after	NotEntity
16	NotEntity
years	NotEntity
of	NotEntity
smoking.	NotEntity
He	NotEntity
has	NotEntity
a	NotEntity
history	Status-B
of	NotEntity
illicit	NotEntity
drug	Drug-B
use	Drug-I
,	NotEntity
but	NotEntity
denies	Status-B
IV	NotEntity
drug	Drug-B
use	Drug-I
.	NotEntity
He	NotEntity
denies	Status-B
any	NotEntity
HIV	NotEntity
risk	NotEntity
factors	NotEntity
and	NotEntity
states	NotEntity
that	NotEntity
his	NotEntity
last	NotEntity
HIV	NotEntity
test	NotEntity
was	NotEntity
over	NotEntity
two	NotEntity
years	NotEntity
ago	NotEntity
