SOCIAL	NotEntity
HISTORY:	NotEntity
She	NotEntity
has	Status-B
a	NotEntity
27	Amount-B
pack	Amount-I
year	Amount-I
smoking	NotEntity
history.	NotEntity
She	NotEntity
denies	Status-B
any	NotEntity
alcohol	Alcohol-B
use.	NotEntity
She	NotEntity
does	Status-B
have	Status-I
a	Status-I
history	Status-I
of	Status-I
chronic	NotEntity
marijuana	Drug-B
use	NotEntity
