SOCIAL	NotEntity
HISTORY:	NotEntity
The	NotEntity
patient	NotEntity
is	Status-B
married	NotEntity
but	NotEntity
has	NotEntity
been	NotEntity
separated	NotEntity
from	NotEntity
his	NotEntity
wife	NotEntity
for	NotEntity
many	NotEntity
years,	NotEntity
they	NotEntity
remain	NotEntity
close,	NotEntity
and	NotEntity
they	NotEntity
have	NotEntity
two	Amount-B
adult	NotEntity
sons.	NotEntity
He	NotEntity
is	NotEntity
retired	Status-B
from	NotEntity
the	NotEntity
Air	NotEntity
Force,	NotEntity
currently	Status-B
works	NotEntity
for	NotEntity
Lockheed	NotEntity
Martin.	NotEntity
He	NotEntity
was	NotEntity
born	NotEntity
and	NotEntity
raised	NotEntity
in	NotEntity
New	NotEntity
York.	NotEntity
He	NotEntity
does	NotEntity
have	NotEntity
a	NotEntity
smoking	Tobacco-B
history,	NotEntity
about	NotEntity
a	NotEntity
20	Amount-B
pack-year	Amount-I
history	NotEntity
and	NotEntity
he	NotEntity
reports	Status-B
quitting	Status-I
on	Status-I
July	Status-I
27.	Status-I
He	NotEntity
does	Status-B
drink	Status-I
alcohol	NotEntity
socially.	Amount-B
No	NotEntity
use	NotEntity
of	NotEntity
illicit	NotEntity
drugs.	Drug-B
