SOCIAL	NotEntity
HISTORY:	NotEntity
The	NotEntity
patient	NotEntity
is	NotEntity
originally	NotEntity
from	NotEntity
Maine.	NotEntity
She	NotEntity
has	NotEntity
lived	Status-B
in	Status-I
Arizona	NotEntity
for	NotEntity
4	NotEntity
years.	NotEntity
She	NotEntity
has	NotEntity
had	NotEntity
2	Amount-B
children;	NotEntity
however,	NotEntity
only	NotEntity
one	NotEntity
is	NotEntity
living.	NotEntity
She	NotEntity
had	NotEntity
one	Amount-B
child	NotEntity
died	NotEntity
from	NotEntity
complications	NotEntity
of	NotEntity
ulcerative	NotEntity
colitis.	NotEntity
She	NotEntity
has	Status-B
been	Status-I
predominantly	Status-I
a	NotEntity
homemaker	Occupation-B
during	NotEntity
her	NotEntity
life,	NotEntity
but	NotEntity
has	Status-B
done	Status-I
some	Status-I
domestic	NotEntity
cleaning	NotEntity
work	NotEntity
in	NotEntity
the	NotEntity
past	NotEntity
