SOCIAL	NotEntity
HISTORY:	NotEntity
She	NotEntity
does	Status-B
not	Status-I
smoke	NotEntity
cigarettes,	Tobacco-B
abuse	NotEntity
alcohol,	Alcohol-B
nor	NotEntity
use	NotEntity
any	NotEntity
illicit	NotEntity
drugs.	Drug-B
She	NotEntity
is	Status-B
retired	Status-I
from	NotEntity
Morse	NotEntity
Chain	NotEntity
and	NotEntity
delivering	Occupation-B
newspapers.	Occupation-I
She	NotEntity
is	Status-B
widowed.	NotEntity
She	NotEntity
lives	Status-B
alone	NotEntity
but	NotEntity
has	NotEntity
family	NotEntity
members	NotEntity
who	NotEntity
live	NotEntity
either	NotEntity
on	NotEntity
her	NotEntity
property	NotEntity
or	NotEntity
adjacent	NotEntity
to	NotEntity
it	NotEntity
