SOCIAL	NotEntity
HISTORY:	NotEntity
She	NotEntity
had	NotEntity
a	NotEntity
baby	NotEntity
five	NotEntity
months	NotEntity
ago.	NotEntity
She	NotEntity
smokes	Status-B
a	NotEntity
half	Amount-B
pack	Amount-I
a	NotEntity
day.	NotEntity
She	NotEntity
denies	Status-B
alcohol	NotEntity
and	NotEntity
drug	Drug-B
use	NotEntity
