SOCIAL	NotEntity
HISTORY:	NotEntity
She	Status-B
is	Status-I
retired	NotEntity
as	NotEntity
a	NotEntity
cook	NotEntity
in	NotEntity
a	NotEntity
school	NotEntity
cafeteria,	NotEntity
where	NotEntity
she	NotEntity
worked	NotEntity
for	NotEntity
34	NotEntity
years.	NotEntity
She	NotEntity
retired	Status-B
7	NotEntity
years	NotEntity
ago	NotEntity
because	NotEntity
of	NotEntity
low	NotEntity
back	NotEntity
pain.	NotEntity
She	NotEntity
used	NotEntity
to	NotEntity
smoke	Tobacco-B
2-1/2	NotEntity
packs	NotEntity
per	Frequency-B
day	Frequency-I
for	NotEntity
32	NotEntity
years,	NotEntity
but	NotEntity
quit	Status-B
in	NotEntity
1995.	NotEntity
Denies	Status-B
alcohol,	NotEntity
and	NotEntity
denies	Status-B
IV	NotEntity
or	NotEntity
illicit	NotEntity
drug	Drug-B
use	NotEntity
