SOCIAL	NotEntity
HISTORY:	NotEntity
At	NotEntity
home	NotEntity
live	Status-B
mom,	NotEntity
dad,	NotEntity
and	NotEntity
18-	Amount-B
,	NotEntity
16-	Amount-B
,	NotEntity
14-	Amount-B
,	NotEntity
12-y	Amount-B
ear-old	NotEntity
brothers,	NotEntity
and	NotEntity
a	NotEntity
3-year-old	Amount-B
sister.	NotEntity
All	NotEntity
the	NotEntity
residents	NotEntity
at	NotEntity
home	NotEntity
are	NotEntity
sick	NotEntity
currently	NotEntity
with	NotEntity
cold,	NotEntity
cough,	NotEntity
runny	NotEntity
nose,	NotEntity
except	NotEntity
for	NotEntity
mom.	NotEntity
At	Status-B
home	NotEntity
also	NotEntity
live	NotEntity
2	Amount-B
dogs	NotEntity
and	NotEntity
2	Amount-B
outside	NotEntity
cats.	NotEntity
Mom	NotEntity
denies	NotEntity
any	NotEntity
recent	NotEntity
travel	NotEntity
history,	NotEntity
especially	NotEntity
during	NotEntity
the	NotEntity
recent	NotEntity
holidays	NotEntity
and	NotEntity
no	Status-B
smoke	NotEntity
exposures	NotEntity
