SOCIAL	NotEntity
HISTORY:	NotEntity
The	NotEntity
patient	NotEntity
is	Status-B
single.	NotEntity
She	NotEntity
is	Status-B
a	NotEntity
full-time	NotEntity
student	NotEntity
at	NotEntity
University.	NotEntity
Uses	NotEntity
no	Status-B
tobacco,	NotEntity
alcohol	Alcohol-B
,	NotEntity
or	NotEntity
illicit	NotEntity
drugs	Drug-B
.	NotEntity
She	NotEntity
exercises	Status-B
weekly,	NotEntity
mainly	NotEntity
tennis	NotEntity
and	NotEntity
swelling	NotEntity
