SOCIAL	NotEntity
HISTORY:	NotEntity
He	NotEntity
is	NotEntity
currently	Status-B
single.	NotEntity
He	NotEntity
drinks	Status-B
alcohol	NotEntity
ten	Amount-B
to	Amount-I
twelve	Amount-I
drinks	Amount-I
a	NotEntity
week,	NotEntity
but	NotEntity
does	NotEntity
not	NotEntity
drink	NotEntity
five	NotEntity
days	NotEntity
a	NotEntity
week	NotEntity
and	NotEntity
then	NotEntity
will	NotEntity
binge	NotEntity
drink.	NotEntity
He	NotEntity
smokes	Status-B
one	NotEntity
and	NotEntity
a	NotEntity
half	NotEntity
pack	NotEntity
a	Frequency-B
day	Frequency-I
for	NotEntity
15	NotEntity
years,	NotEntity
but	NotEntity
he	NotEntity
has	Tobacco-B
recently	NotEntity
stopped	Status-B
smoking	Status-I
for	NotEntity
the	NotEntity
past	NotEntity
two	NotEntity
weeks	NotEntity
