SOCIAL	NotEntity
HISTORY:	NotEntity
He	NotEntity
is	Status-B
currently	Status-I
single.	NotEntity
He	Status-B
has	Status-I
about	NotEntity
ten	Alcohol-B
drinks	Alcohol-I
a	Alcohol-I
year.	Alcohol-I
He	NotEntity
had	Status-B
smoked	NotEntity
significantly	Amount-B
up	NotEntity
until	NotEntity
several	NotEntity
months	NotEntity
ago.	NotEntity
He	NotEntity
now	Status-B
smokes	Status-I
less	NotEntity
than	NotEntity
three	NotEntity
cigarettes	NotEntity
a	Frequency-B
day	Frequency-I
