SOCIAL	NotEntity
HISTORY:	NotEntity
He	NotEntity
is	Status-B
married	NotEntity
and	NotEntity
has	NotEntity
support	NotEntity
at	NotEntity
home.	NotEntity
He	NotEntity
denies	Status-B
tobacco	NotEntity
and	NotEntity
illicit	NotEntity
drug	Drug-B
use	NotEntity
and	NotEntity
drinks	Status-B
two	NotEntity
to	NotEntity
three	NotEntity
alcoholic	NotEntity
beverages	NotEntity
a	Frequency-B
day	Frequency-I
and	NotEntity
up	NotEntity
to	NotEntity
four	NotEntity
to	NotEntity
nine	NotEntity
per	NotEntity
week	NotEntity
