SOCIAL	NotEntity
HISTORY:	NotEntity
The	NotEntity
patient	NotEntity
is	NotEntity
a	NotEntity
civil	NotEntity
engineer,	NotEntity
who	NotEntity
currently	Status-B
works	NotEntity
from	NotEntity
home.	NotEntity
She	NotEntity
is	NotEntity
working	NotEntity
approximately	NotEntity
half	NotEntity
time	NotEntity
because	NotEntity
of	NotEntity
limitations	NotEntity
imposed	NotEntity
on	NotEntity
her	NotEntity
by	NotEntity
her	NotEntity
disability,	NotEntity
need	NotEntity
to	NotEntity
attend	NotEntity
frequent	NotEntity
physical	NotEntity
therapy,	NotEntity
and	NotEntity
also	NotEntity
the	NotEntity
needs	NotEntity
of	NotEntity
looking	NotEntity
after	NotEntity
her	NotEntity
baby.	NotEntity
She	NotEntity
does	Status-B
not	Status-I
smoke	NotEntity
and	NotEntity
does	Status-B
not	Status-I
drink	NotEntity
and	NotEntity
has	NotEntity
never	NotEntity
done	NotEntity
either	NotEntity
