SOCIAL	NotEntity
HISTORY:	NotEntity
The	NotEntity
patient	NotEntity
is	Status-B
married	Status-I
and	NotEntity
lives	Status-B
with	NotEntity
his	NotEntity
spouse.	NotEntity
He	NotEntity
has	NotEntity
history	Status-B
of	Status-I
tobacco	NotEntity
smoking	NotEntity
and	NotEntity
also	NotEntity
reports	NotEntity
history	Status-B
of	Status-I
alcohol	NotEntity
abuse.	Amount-B
No	NotEntity
history	NotEntity
of	NotEntity
illicit	NotEntity
drug	Drug-B
abuse	NotEntity
