SOCIAL	NotEntity
HISTORY:	NotEntity
She	NotEntity
smokes	Status-B
about	NotEntity
6-7	Amount-B
cigarettes	NotEntity
per	Frequency-B
day	Frequency-I
and	NotEntity
has	NotEntity
done	NotEntity
so	NotEntity
for	NotEntity
more	NotEntity
than	NotEntity
50	NotEntity
years.	NotEntity
She	NotEntity
quit	Status-B
smoking	Status-I
about	NotEntity
6	NotEntity
weeks	NotEntity
ago.	NotEntity
She	NotEntity
occasionally	Status-B
has	NotEntity
alcohol.	Alcohol-B
She	NotEntity
is	Status-B
married	Status-I
and	NotEntity
has	NotEntity
3	Amount-B
children.	NotEntity
She	NotEntity
lives	Status-B
at	NotEntity
home	NotEntity
with	NotEntity
her	NotEntity
husband.	NotEntity
She	NotEntity
used	Status-B
to	Status-I
work	NotEntity
as	NotEntity
a	NotEntity
unit	NotEntity
clerk	NotEntity
at	NotEntity
XYZ	NotEntity
Medical	NotEntity
Center	NotEntity
