SOCIAL	NotEntity
HISTORY:	NotEntity
He	NotEntity
previously	Status-B
worked	Status-I
with	NotEntity
pipeline	Occupation-B
work,	Occupation-I
but	Occupation-I
has	Occupation-I
been	Occupation-I
on	Occupation-I
disability	Occupation-I
for	Occupation-I
five	Occupation-I
years	Occupation-I
.	NotEntity
He	NotEntity
is	NotEntity
unsure	NotEntity
which	NotEntity
symptoms	NotEntity
led	NotEntity
him	NotEntity
to	NotEntity
go	NotEntity
on	NotEntity
disability.	NotEntity
He	NotEntity
has	NotEntity
previously	Status-B
smoked	NotEntity
about	NotEntity
two	Amount-B
packs	Amount-I
of	NotEntity
cigarettes	NotEntity
daily	NotEntity
for	NotEntity
20	NotEntity
years,	NotEntity
but	NotEntity
quit	NotEntity
about	NotEntity
20	NotEntity
years	NotEntity
ago.	NotEntity
He	NotEntity
denies	Status-B
alcohol	NotEntity
or	NotEntity
illicit	NotEntity
drug	Drug-B
use.	NotEntity
He	NotEntity
lives	Status-B
with	NotEntity
his	NotEntity
wife.	NotEntity
He	NotEntity
does	NotEntity
not	NotEntity
really	NotEntity
have	NotEntity
any	NotEntity
hobbies	NotEntity
