SOCIAL	NotEntity
HISTORY:	NotEntity
She	NotEntity
works	Status-B
as	NotEntity
a	NotEntity
cook	NotEntity
for	NotEntity
a	NotEntity
nursing	NotEntity
home,	NotEntity
is	Status-B
single	NotEntity
and	NotEntity
has	NotEntity
one	Amount-B
daughter.	NotEntity
Never	Status-B
smoked.	NotEntity
Denies	Status-B
any	NotEntity
alcohol	Alcohol-B
.	NotEntity
Has	NotEntity
not	Status-B
been	Status-I
sexually	NotEntity
active	NotEntity
in	NotEntity
a	NotEntity
long	NotEntity
time	NotEntity
