SOCIAL	NotEntity
HISTORY:	NotEntity
The	NotEntity
patient	NotEntity
is	Status-B
a	Status-I
homemaker.	Status-I
She	NotEntity
is	Status-B
married,	Status-I
with	NotEntity
2	Amount-B
children	NotEntity
aged	NotEntity
22	NotEntity
and	NotEntity
28.	NotEntity
She	NotEntity
is	NotEntity
a	NotEntity
lifelong	NotEntity
nons	Status-B
moker	NotEntity
and	NotEntity
nond	Status-B
rinker	NotEntity
