SOCIAL	NotEntity
HISTORY:	NotEntity
Discussed	NotEntity
above	NotEntity
and	NotEntity
documented	NotEntity
on	NotEntity
the	NotEntity
chart.	NotEntity
He	NotEntity
does	Status-B
not	Status-I
smoke.	NotEntity
He	NotEntity
lives	Status-B
in	NotEntity
a	NotEntity
senior	NotEntity
citizens	NotEntity
building	NotEntity
with	NotEntity
daily	NotEntity
nursing	NotEntity
aids.	NotEntity
He	NotEntity
previously	Status-B
was	NotEntity
a	NotEntity
security	NotEntity
guard,	NotEntity
but	NotEntity
is	NotEntity
currently	NotEntity
on	NotEntity
disability	NotEntity
