SOCIAL	NotEntity
HISTORY:	NotEntity
The	NotEntity
patient	NotEntity
stopped	Status-B
smoking	NotEntity
27	NotEntity
years	NotEntity
ago,	NotEntity
he	NotEntity
smoked	NotEntity
approximately	NotEntity
two	Amount-B
packs	Amount-I
a	NotEntity
day	NotEntity
with	NotEntity
combined	NotEntity
cigarettes	NotEntity
and	NotEntity
cigars.	NotEntity
He	NotEntity
has	NotEntity
not	NotEntity
smoked	Tobacco-B
for	NotEntity
the	NotEntity
past	NotEntity
27	NotEntity
years.	NotEntity
He	NotEntity
hardly	Frequency-B
ever	Frequency-I
uses	NotEntity
alcohol	Alcohol-B
.	NotEntity
He	NotEntity
is	NotEntity
currently	Status-B
retired	NotEntity
