SUBSTANCE	NotEntity
USE:	NotEntity
Ms.	NotEntity
A	NotEntity
denied	Status-B
drinking	NotEntity
alcohol	NotEntity
or	NotEntity
using	NotEntity
illicit	NotEntity
drugs	Drug-B
.	NotEntity
She	NotEntity
used	Status-B
to	Status-I
smoke	NotEntity
a	Amount-B
pack	Amount-I
of	NotEntity
cigarettes	NotEntity
per	Frequency-B
day	Frequency-I
,	NotEntity
but	NotEntity
quit	NotEntity
five	NotEntity
to	NotEntity
six	NotEntity
years	NotEntity
ago	NotEntity
