DRUG	NotEntity
HISTORY:	NotEntity
He	NotEntity
stopped	Status-B
using	NotEntity
drugs	Drug-B
when	NotEntity
he	NotEntity
was	NotEntity
25.	NotEntity
He	NotEntity
has	NotEntity
got	NotEntity
a	NotEntity
lapse,	NotEntity
but	NotEntity
he	NotEntity
was	NotEntity
more	NotEntity
than	NotEntity
10	NotEntity
years	NotEntity
and	NotEntity
he	NotEntity
has	NotEntity
been	NotEntity
clean	NotEntity
ever	NotEntity
since	NotEntity
then.	NotEntity
As	NotEntity
mentioned	NotEntity
before	Status-B
,	NotEntity
he	NotEntity
smokes	Tobacco-B
cigarettes	NotEntity
quite	Amount-B
heavily	Amount-I
and	NotEntity
which	NotEntity
has	NotEntity
been	NotEntity
a	NotEntity
problem	NotEntity
for	NotEntity
his	NotEntity
health	NotEntity
since	NotEntity
he	NotEntity
also	NotEntity
has	NotEntity
chronic	NotEntity
bronchitis	NotEntity
