SOCIAL	NotEntity
HISTORY:	NotEntity
He	NotEntity
has	Status-B
about	NotEntity
a	NotEntity
30-pack-a-year	Amount-B
history	NotEntity
of	NotEntity
smoking	Tobacco-B
.	NotEntity
He	NotEntity
used	Status-B
to	Status-I
drink	Status-I
alcohol	NotEntity
heavily	Amount-B
and	NotEntity
has	NotEntity
a	NotEntity
history	NotEntity
of	NotEntity
getting	NotEntity
a	NotEntity
DUI	NotEntity
about	NotEntity
a	NotEntity
year-and-half	NotEntity
ago	NotEntity
resulting	NotEntity
in	NotEntity
him	NotEntity
having	NotEntity
his	NotEntity
truck-driving	Occupation-B
license	NotEntity
revoked.	NotEntity
Since	NotEntity
that	NotEntity
time	NotEntity
he	NotEntity
has	NotEntity
worked	NotEntity
with	NotEntity
printing	NotEntity
press.	NotEntity
He	NotEntity
is	Status-B
married	NotEntity
and	NotEntity
has	NotEntity
two	Amount-B
children,	NotEntity
both	NotEntity
of	NotEntity
whom	NotEntity
are	NotEntity
grown	NotEntity
in	NotEntity
their	NotEntity
20s,	NotEntity
but	NotEntity
are	NotEntity
now	NotEntity
living	Status-B
at	Status-I
home	Status-I
