SOCIAL	NotEntity
HISTORY:	NotEntity
The	NotEntity
patient	NotEntity
is	Status-B
married	Status-I
.	NotEntity
She	NotEntity
is	Status-B
employed	Status-I
as	NotEntity
an	NotEntity
office	NotEntity
manager.	NotEntity
She	NotEntity
does	Status-B
smoke	NotEntity
cigarettes,	NotEntity
one	Amount-B
pack	Amount-I
per	NotEntity
day	NotEntity
for	NotEntity
the	NotEntity
last	NotEntity
20	NotEntity
years.	NotEntity
She	NotEntity
consumes	Status-B
alcohol	NotEntity
3	Amount-B
to	Amount-I
5	Amount-I
drinks	Amount-I
daily.	NotEntity
She	NotEntity
uses	Status-B
no	Status-I
illicit	NotEntity
drugs	Drug-B
.	NotEntity
She	NotEntity
exercises	Status-B
monthly	NotEntity
mainly	NotEntity
walking	NotEntity
and	NotEntity
low	NotEntity
impact	NotEntity
aerobics.	NotEntity
She	NotEntity
also	NotEntity
likes	Status-B
to	Status-I
play	Status-I
softball	NotEntity
