SOCIAL	NotEntity
HISTORY:	NotEntity
The	NotEntity
patient	NotEntity
is	Status-B
married.	NotEntity
Has	NotEntity
four	Amount-B
adult	NotEntity
children.	NotEntity
Good	NotEntity
health.	NotEntity
She	NotEntity
is	NotEntity
a	NotEntity
lifetime	NotEntity
nons	Status-B
moker,	NotEntity
social	Amount-B
alcohol	NotEntity
drinker	NotEntity
