SOCIAL	NotEntity
HISTORY:	NotEntity
The	NotEntity
patient	NotEntity
lives	Status-B
alone.	NotEntity
He	NotEntity
is	Status-B
unemployed,	NotEntity
disabled.	NotEntity
He	NotEntity
has	Status-B
history	Status-I
of	Status-I
tobacco	NotEntity
use	NotEntity
in	NotEntity
the	NotEntity
past.	NotEntity
He	NotEntity
denies	Status-B
alcohol	NotEntity
or	NotEntity
drug	Drug-B
abuse	NotEntity
