SOCIAL	NotEntity
HISTORY:	NotEntity
The	NotEntity
patient	NotEntity
smokes	Status-B
approximately	NotEntity
2	NotEntity
packs	NotEntity
per	Frequency-B
day	Frequency-I
times	NotEntity
greater	NotEntity
than	NotEntity
40	NotEntity
years.	NotEntity
He	NotEntity
does	Status-B
drink	Status-I
occasional	NotEntity
alcohol	NotEntity
approximately	NotEntity
5	Amount-B
to	Amount-I
6	Amount-I
alcoholic	NotEntity
drinks	NotEntity
per	Frequency-B
month.	Frequency-I
He	NotEntity
denies	Status-B
any	NotEntity
drug	Drug-B
use.	Drug-I
He	NotEntity
is	Status-B
a	Status-I
retired	NotEntity
liquor	Occupation-B
store	Occupation-I
owner.	Occupation-I
