SOCIAL	NotEntity
AND	NotEntity
DEVELOPMENTAL	NotEntity
HISTORY:	NotEntity
The	NotEntity
patient	NotEntity
has	Status-B
been	Status-I
living	Status-I
in	NotEntity
his	NotEntity
father's	NotEntity
home	NotEntity
and	NotEntity
this	NotEntity
is	NotEntity
all	NotEntity
the	NotEntity
information	NotEntity
that	NotEntity
we	NotEntity
have	NotEntity
available	NotEntity
from	NotEntity
the	NotEntity
chart	NotEntity
