IDENTIFYING	NotEntity
DATA:	NotEntity
The	NotEntity
patient	NotEntity
is	NotEntity
a	NotEntity
45-year-old	NotEntity
white	NotEntity
male.	NotEntity
He	NotEntity
is	Status-B
unemployed,	Status-I
presumably	NotEntity
on	NotEntity
disability	NotEntity
and	NotEntity
lives	Status-B
with	NotEntity
his	NotEntity
partner	NotEntity
