SOCIAL	NotEntity
HISTORY:	NotEntity
The	NotEntity
patient	NotEntity
lives	Status-B
alone	NotEntity
in	NotEntity
an	NotEntity
apartment	NotEntity
uses	NotEntity
prior	NotEntity
to	NotEntity
sobriety	NotEntity
15	NotEntity
months	NotEntity
ago.	NotEntity
He	NotEntity
was	Status-B
a	NotEntity
binge	Amount-B
drinker,	NotEntity
although	NotEntity
unable	NotEntity
to	NotEntity
provide	NotEntity
detail	NotEntity
about	NotEntity
frequency	NotEntity
of	NotEntity
binges.	NotEntity
The	NotEntity
patient	NotEntity
does	Status-B
not	Status-I
work	NotEntity
since	NotEntity
brother	NotEntity
became	NotEntity
ill	NotEntity
3	NotEntity
months	NotEntity
ago	NotEntity
when	NotEntity
he	NotEntity
quit	NotEntity
his	NotEntity
job	NotEntity
to	NotEntity
care	NotEntity
for	NotEntity
him	NotEntity
