SOCIAL	NotEntity
HISTORY:	NotEntity
The	NotEntity
patient	NotEntity
is	NotEntity
a	NotEntity
nons	Status-B
moker.	NotEntity
Denies	Status-B
any	Status-I
alcohol	NotEntity
or	NotEntity
illicit	NotEntity
drug	Drug-B
use.	NotEntity
The	NotEntity
patient	NotEntity
does	Status-B
live	Status-I
with	NotEntity
his	NotEntity
family	NotEntity
