FAMILY	NotEntity
HISTORY	NotEntity
AND	NotEntity
SOCIAL	NotEntity
HISTORY:	NotEntity
Significant	NotEntity
for	NotEntity
Huntington	NotEntity
disease	NotEntity
in	NotEntity
her	NotEntity
mother	NotEntity
and	NotEntity
diabetes	NotEntity
in	NotEntity
her	NotEntity
father.	NotEntity
Her	NotEntity
brother	NotEntity
has	NotEntity
an	NotEntity
aneurysm.	NotEntity
She	NotEntity
does	Status-B
occasionally	Status-I
smoke	Status-I
and	NotEntity
has	NotEntity
been	NotEntity
trying	NotEntity
to	NotEntity
quit	NotEntity
recently.	NotEntity
She	NotEntity
is	NotEntity
currently	Status-B
smoking	NotEntity
about	Amount-B
a	Amount-I
pack	Amount-I
a	NotEntity
day.	NotEntity
She	NotEntity
drinks	Status-B
about	NotEntity
once	Frequency-B
a	Frequency-I
week	Frequency-I
.	NotEntity
She	NotEntity
is	NotEntity
currently	Status-B
a	NotEntity
registered	Occupation-B
nurse,	Occupation-I
circulator,	Occupation-I
and	Occupation-I
scrub	Occupation-I
technician	Occupation-I
in	NotEntity
the	NotEntity
operating	NotEntity
room	NotEntity
at	NotEntity
Hopkins.	NotEntity
She	NotEntity
has	NotEntity
no	NotEntity
children	NotEntity
