SOCIAL	NotEntity
HISTORY:	NotEntity
History	Status-B
of	Status-I
tobacco	NotEntity
use,	NotEntity
smoked	NotEntity
for	NotEntity
20	NotEntity
years,	NotEntity
and	NotEntity
quit	NotEntity
30	NotEntity
years	NotEntity
ago.	NotEntity
Alcohol	Alcohol-B
one	NotEntity
to	NotEntity
two	NotEntity
drinks	NotEntity
monthly.	Status-B
