SOCIAL	NotEntity
HISTORY:	NotEntity
The	NotEntity
patient	NotEntity
lives	Status-B
at	NotEntity
home	NotEntity
with	NotEntity
23-year-old	Amount-B
mother,	NotEntity
who	NotEntity
is	NotEntity
a	NotEntity
homemaker	NotEntity
and	NotEntity
24-year-old	Amount-B
father,	NotEntity
John,	NotEntity
who	NotEntity
is	NotEntity
a	NotEntity
supervisor	NotEntity
at	NotEntity
Excel.	NotEntity
The	NotEntity
family	NotEntity
lives	Status-B
in	NotEntity
Bentley,	NotEntity
Kansas.	NotEntity
No	Status-B
smoking	NotEntity
in	NotEntity
the	NotEntity
home.	NotEntity
Family	NotEntity
does	NotEntity
have	NotEntity
one	NotEntity
pet	NotEntity
cat	NotEntity
