SOCIAL	NotEntity
HISTORY:	NotEntity
She	NotEntity
drinks	Status-B
four	NotEntity
cups	NotEntity
of	NotEntity
coffee	Drug-B
a	NotEntity
day.	NotEntity
No	NotEntity
soda.	NotEntity
No	NotEntity
chocolate.	NotEntity
She	NotEntity
said	NotEntity
her	NotEntity
husband	NotEntity
hurt	NotEntity
his	NotEntity
hand	NotEntity
and	NotEntity
shoulder,	NotEntity
and	NotEntity
she	NotEntity
has	NotEntity
been	NotEntity
having	NotEntity
to	NotEntity
care	NotEntity
of	NotEntity
him	NotEntity
pretty	NotEntity
much.	NotEntity
They	NotEntity
walk	Status-B
every	NotEntity
evening	NotEntity
for	Amount-B
one	Amount-I
hour.	Amount-I
