SOCIAL	NotEntity
HISTORY:	NotEntity
Prior	Status-B
to	Status-I
admission	Status-I
,	NotEntity
the	NotEntity
patient	NotEntity
lived	NotEntity
alone	NotEntity
in	NotEntity
a	NotEntity
one	NotEntity
storied	NotEntity
dwelling.	NotEntity
She	NotEntity
does	NotEntity
have	NotEntity
some	NotEntity
equipment	NotEntity
at	NotEntity
home	NotEntity
including	NotEntity
a	NotEntity
powered	NotEntity
wheelchair,	NotEntity
which	NotEntity
she	NotEntity
uses	NotEntity
for	NotEntity
longer	NotEntity
distance.	NotEntity
She	NotEntity
does	NotEntity
have	NotEntity
some	NotEntity
ambulatory	NotEntity
devices	NotEntity
also.	NotEntity
She	NotEntity
used	NotEntity
to	NotEntity
smoke	Status-B
,	NotEntity
but	NotEntity
quit	NotEntity
about	NotEntity
10	NotEntity
years	NotEntity
ago.	NotEntity
She	NotEntity
smoked	Status-B
1	NotEntity
to	NotEntity
2	NotEntity
packs	NotEntity
a	Frequency-B
day	Frequency-I
from	NotEntity
age	NotEntity
18	NotEntity
to	NotEntity
54.	NotEntity
She	NotEntity
does	Status-B
not	Status-I
smoke	NotEntity
