SOCIAL	NotEntity
HISTORY:	NotEntity
The	NotEntity
patient	NotEntity
is	Status-B
married.	NotEntity
He	NotEntity
had	NotEntity
1	Amount-B
child	NotEntity
who	NotEntity
died	NotEntity
at	NotEntity
the	NotEntity
age	NotEntity
of	NotEntity
26	NotEntity
months	NotEntity
of	NotEntity
unknown	NotEntity
etiology.	NotEntity
He	NotEntity
quit	Status-B
smoking	Status-I
6	NotEntity
years	NotEntity
ago	NotEntity
but	NotEntity
dips	Status-B
(smokeless)	NotEntity
tobacco	Tobacco-B
