SOCIAL	NotEntity
HISTORY:	NotEntity
The	NotEntity
patient	NotEntity
is	Status-B
married,	Status-I
lives	NotEntity
with	NotEntity
her	NotEntity
husband.	NotEntity
She	NotEntity
is	NotEntity
a	NotEntity
lifetime	Status-B
nons	Status-I
moker,	NotEntity
nond	Status-B
rinker.	NotEntity
She	NotEntity
has	NotEntity
not	Status-B
been	Status-I
getting	Status-I
regular	NotEntity
exercise	NotEntity
for	NotEntity
approximately	NotEntity
two	NotEntity
years	NotEntity
due	NotEntity
to	NotEntity
chronic	NotEntity
sciatic	NotEntity
pain	NotEntity
