SOCIAL	NotEntity
HISTORY:	NotEntity
She	NotEntity
lives	Status-B
with	Status-I
husband,	NotEntity
who	Amount-B
is	Amount-I
elderly	Amount-I
,	NotEntity
cannot	NotEntity
take	NotEntity
care	NotEntity
of	NotEntity
her.	NotEntity
She	NotEntity
does	Status-B
not	Status-I
smoke	NotEntity
or	NotEntity
drink	Alcohol-B
alcohol	Alcohol-I
currently	NotEntity
