SOCIAL	NotEntity
HISTORY:	NotEntity
She	NotEntity
smoked	Tobacco-B
cigarettes	NotEntity
socially	Amount-B
while	NotEntity
in	NotEntity
her	NotEntity
20s.	NotEntity
A	Amount-B
pack	Amount-I
of	NotEntity
cigarettes	NotEntity
would	Status-B
last	NotEntity
for	Frequency-B
more	Frequency-I
than	Frequency-I
a	Frequency-I
week	Frequency-I
.	NotEntity
She	NotEntity
does	Status-B
not	Status-I
smoke	NotEntity
now.	NotEntity
She	Status-B
has	Status-I
two	NotEntity
glasses	NotEntity
of	NotEntity
wine	NotEntity
per	Frequency-B
day	Frequency-I
,	NotEntity
both	NotEntity
red	NotEntity
and	NotEntity
white	NotEntity
wine.	NotEntity
She	NotEntity
is	Status-B
married	Status-I
and	NotEntity
has	NotEntity
no	NotEntity
children.	NotEntity
An	NotEntity
IUD	NotEntity
was	NotEntity
recently	NotEntity
placed.	NotEntity
She	NotEntity
works	Status-B
as	NotEntity
an	NotEntity
esthetician	NotEntity
