PERSONAL	NotEntity
AND	NotEntity
SOCIAL	NotEntity
HISTORY:	NotEntity
Marital	NotEntity
status:	NotEntity
Married	Status-B
.	NotEntity
Smoking	NotEntity
history:	NotEntity
Smoked	Tobacco-B
1	NotEntity
PPD,	NotEntity
quit	NotEntity
12	NotEntity
years	NotEntity
ago	NotEntity
and	NotEntity
after	NotEntity
smoking	NotEntity
for	NotEntity
30	NotEntity
years.	NotEntity
Alcohol	NotEntity
history:	NotEntity
Drinks	Status-B
socially.	NotEntity
Denies	Status-B
any	Status-I
history	Status-I
of	NotEntity
drug	Drug-B
abuse	NotEntity
