SOCIAL	NotEntity
HISTORY:	NotEntity
She	NotEntity
works	Status-B
at	NotEntity
nursing	NotEntity
home.	NotEntity
She	NotEntity
is	NotEntity
a	NotEntity
non	Status-B
smoker.	NotEntity
She	NotEntity
is	NotEntity
currently	NotEntity
trying	NotEntity
to	NotEntity
lose	NotEntity
weight.	NotEntity
She	NotEntity
is	NotEntity
on	NotEntity
the	NotEntity
diet	NotEntity
and	NotEntity
has	NotEntity
lost	NotEntity
several	NotEntity
pounds	NotEntity
in	NotEntity
the	NotEntity
last	NotEntity
several	NotEntity
months.	NotEntity
She	NotEntity
quit	NotEntity
smoking	Status-B
in	NotEntity
1972	NotEntity
