SOCIAL	NotEntity
HISTORY:	NotEntity
The	NotEntity
patient	NotEntity
has	Status-B
been	NotEntity
a	NotEntity
smoker	Tobacco-B
since	NotEntity
the	NotEntity
age	NotEntity
of	NotEntity
10.	NotEntity
So,	NotEntity
he	NotEntity
was	Status-B
smoking	NotEntity
2-3	Amount-B
packs	Amount-I
per	NotEntity
day.	NotEntity
Since	NotEntity
being	NotEntity
started	NotEntity
on	NotEntity
Chantix,	NotEntity
he	NotEntity
says	NotEntity
he	NotEntity
has	Status-B
cut	Status-I
it	Status-I
down	Status-I
to	Status-I
half	NotEntity
a	NotEntity
pack	NotEntity
per	Frequency-B
day.	Frequency-I
He	NotEntity
does	Status-B
not	Status-I
abuse	NotEntity
alcohol.	Alcohol-B
